3 3 0 0 0 0 0 0 6 5 3 0 0 10 6 11 0 0 12 13 9 0 0 0 0 0 0 
4 4 0 0 0 0 0 0 0 6 7 5 3 0 0 14 9 6 9 0 0 10 6 13 3 0 0 12 13 5 9 0 0 0 0 0 0 0 
5 5 0 0 0 0 0 0 0 0 6 3 6 5 3 0 0 10 10 10 6 11 0 0 14 13 11 10 10 0 0 10 6 13 11 10 0 0 12 13 5 13 9 0 0 0 0 0 0 0 0 
6 6 0 0 0 0 0 0 0 0 0 6 5 7 7 7 3 0 0 12 7 9 10 10 10 0 0 6 11 6 13 11 10 0 0 10 14 11 6 13 9 0 0 10 14 13 13 5 3 0 0 12 13 5 5 5 9 0 0 0 0 0 0 0 0 0 
7 7 0 0 0 0 0 0 0 0 0 0 6 5 7 7 5 5 3 0 0 10 6 9 12 3 6 9 0 0 12 11 6 5 11 12 3 0 0 6 9 12 7 11 6 9 0 0 12 7 3 14 9 14 3 0 0 6 13 11 12 5 11 10 0 0 12 5 13 5 5 13 9 0 0 0 0 0 0 0 0 0 0 
8 8 0 0 0 0 0 0 0 0 0 0 0 6 3 6 5 3 6 7 3 0 0 14 13 13 7 13 13 9 10 0 0 10 6 5 9 6 7 5 9 0 0 14 11 6 7 13 11 6 3 0 0 14 13 11 12 5 13 13 11 0 0 12 3 10 6 5 3 6 9 0 0 6 13 9 10 6 11 14 3 0 0 12 5 5 13 9 12 13 9 0 0 0 0 0 0 0 0 0 0 0 
9 9 0 0 0 0 0 0 0 0 0 0 0 0 6 7 5 5 5 3 6 5 3 0 0 10 14 5 7 5 9 10 6 9 0 0 10 10 6 13 5 3 10 14 3 0 0 10 12 13 7 3 14 9 14 9 0 0 14 5 5 9 14 13 3 12 3 0 0 12 3 6 5 11 6 13 3 10 0 0 6 13 13 3 10 14 3 12 9 0 0 10 6 3 10 10 14 9 6 3 0 0 12 9 12 13 9 12 5 13 9 0 0 0 0 0 0 0 0 0 0 0 0 
10 10 0 0 0 0 0 0 0 0 0 0 0 0 0 6 3 6 3 6 5 3 6 7 3 0 0 10 14 9 14 11 6 13 11 12 9 0 0 14 9 6 9 12 9 6 11 6 3 0 0 10 6 9 6 5 7 9 12 9 10 0 0 10 10 6 11 6 9 6 5 5 9 0 0 14 9 12 11 14 7 13 5 5 3 0 0 14 3 6 11 12 11 6 7 3 10 0 0 10 14 9 10 6 11 14 11 12 11 0 0 14 13 5 9 14 9 12 11 6 11 0 0 12 5 5 5 13 5 5 13 13 9 0 0 0 0 0 0 0 0 0 0 0 0 0 
11 11 0 0 0 0 0 0 0 0 0 0 0 0 0 0 6 5 5 7 7 7 5 7 5 7 3 0 0 14 3 6 9 10 12 5 13 5 13 11 0 0 10 14 9 6 11 6 7 7 5 3 10 0 0 10 10 6 9 12 9 14 9 6 9 10 0 0 14 11 14 3 6 5 11 6 9 6 9 0 0 14 9 10 10 14 7 9 12 5 13 3 0 0 14 7 9 12 11 10 6 3 6 5 9 0 0 10 14 5 5 9 12 11 10 14 5 3 0 0 12 13 3 6 5 3 14 9 14 5 11 0 0 6 5 11 10 6 13 9 6 13 3 10 0 0 12 5 13 9 12 5 5 13 5 13 9 0 0 0 0 0 0 0 0 0 0 0 0 0 0 
12 12 0 0 0 0 0 0 0 0 0 0 0 0 0 0 0 6 7 7 5 7 7 3 6 5 3 6 3 0 0 14 11 12 5 9 10 14 13 7 13 9 10 0 0 12 9 6 3 6 13 13 3 10 6 7 11 0 0 6 5 9 10 14 3 6 9 10 10 14 9 0 0 10 6 5 13 13 9 12 7 9 10 12 3 0 0 10 14 5 7 7 5 5 13 3 10 6 9 0 0 10 14 7 11 10 6 3 6 11 12 13 3 0 0 12 11 14 13 11 10 14 13 9 6 7 11 0 0 6 11 10 6 9 10 12 3 6 13 11 10 0 0 12 9 14 11 6 11 6 13 13 3 14 11 0 0 6 5 9 14 13 9 12 5 3 14 9 10 0 0 12 5 5 13 5 5 5 5 9 12 5 9 0 0 0 0 0 0 0 0 0 0 0 0 0 0 0 
